#########################################
#         #       #                 #   #
# # ##### ##### # # ############# # # # #
# #     #       # #   #   #   #   # # # #
# ##### # ########### # # # # # ##### # #
#   #   # #         #   #   # #   #   # #
### # ### # ##### ########### ### # ### #
# # # #   # #   #         # #   # #   # #
# # # # ### ### ####### # # ### # ### # #
# # # #   #     #     # #     # #   # # #
# # # # ####### ### ### # ##### # ### # #
# # # # #           #   # #     #     # #
# # # ### ########### ##### ########### #
#   #           #   # #       #     #   #
# ##### ######### # # # ##### # ### # # #
# #   # #         # #   #   # # #     # #
### # ### ######### ##### # ### # ##### #
#   #           #   #     #   # # #   # #
# ############# # ### ####### # ### # ###
#   # #       # #     #       #     #   #
### # # ##### ######### ########### ### #
# #   #   #   #       #     #     #   # #
# ### ### # ### ########### # # # ##### #
#   #   # #   #   #   #     # # # #   # #
# # ### # ### ### # # # ####### # # # # #
# #   # # # #   # # # # #       # # # # #
# ##### # # ### # # # # # ####### # # # #
# #     #   # #   # # # #   #       #   #
# # ####### # ##### # # ### ########### #
#   #     # #   #   # # #   #         # #
# ### ### # # # # # # # # # # ####### ###
# # # #   # # # # # #   # # # #     #   #
# # # # ### # # # # ##### ### ##### ### #
# #   # #   # #   #   #   #   #     #   #
# ### # # ########### # # # ### ##### ###
#   #o# #             # # #     #   #   #
### ### ################# ##### # # ### #
# #   #   #       #     #       # #   # #
# ### # # ### ### # ### ######### ### # #
#       #     #     #             #     #
#########################################
